=.....................................................................=
=.....................................................................=
=...........................$$$$$.....................................=
=.....................................................................=
=.....................................................................=
=.........................................................$...........=
=..................$$$.....*******..........$$...........$*...........=
=.......................................................$**...........=
=....$$$$..........***.................................$***.....$$$$$$=
=.......................................|)............$****.....$$$$$$=
=....**?*...............................|)...........$*****.....$$$$$$=
=.......................................|)..........$******.....$$$$$$=
=..............|).......|)..............|).........$*******.....$$$$$$=
=..............().......()..............().........********.....$$$$$$=
=======================================================================
=======================================================================