=.....................................................................=
=.....................................................................=
=...........................$$$$$.....................................=
=.....................................................................=
=.....................................................................=
=.........................................................$...........=
=..................$$$.....*******..........$$...........$*...........=
=.......................................................$**...........=
=....$$$$..........***.................................$***.....$$$$$$=
=.......................................|)............$****.....$$$$$$=
=....**?*...............................()...........$*****.....$$$$$$=
=.......................|)............../)..........$******.....$$$$$$=
=..............|).......()............../).........$*******.....$$$$$$=
=..............()......./)............../).........********.....$$$$$$=
=======================================================================
=======================================================================