=...................................=
=...................................=
=...................................=
=...................................=
=..................$$$..............=
=...................................=
=....$$$$..........***..............=
=...................................=
=....**?*...........................=
=..............|).......|)..........=
=..............().......()..........=
=====================================
=====================================
=====================================