=...................................=
=...................................=
=...................................=
=.................$$$...............=
=...................................=
=....$$$$.........***...............=
=....**?*......().......()..........=
=..............|).......|)..........=
=====================================
=====================================