=...................................=
=...................................=
=..................$$$..............=
=...................................=
=....$$$$..........***..............=
=...................................=
=....**?*......().......()..........=
=..............|).......|)..........=
=====================================
=====================================